WTXTTTZTTTT
TTTTXTXTT1T
TTTXTTTTTTT
TXTT2TTTT1T
TTXTTTTTTTT
2TXTXTXTXTX
