WTXTTTZTTTT
TTTTXTXTT1T
TTTXTTT1TTT
TXTT2TTTT1T
TTXTT1TTTTT
2TXTXTXTXTX
